1111111111111111111111111111111
1000000000000000000000000000001
1000000000000000000000000000001
1001111111111100111111111111001
1001         1001          1001
1001         1001          1001
1001         1001          1001
1001         1001          1001
1001         1001          1001
1001         1001          1001
1001111111111100111111111111001
100000000000000000000000S000001
1000000000000000000000000000001
1111111111111111111111111111111