NO ../textures/texture1
SO ../textures/texture2
WE ../textures/texture3
EA ../textures/texture4

F 220,100,0
C 225,30,0

11111111111111111111
100000N0000000000001111
100000000011000000000001111111001
1111111111111111111111111