NO   ./textures/texture1                
SO  ./textures/texture2               
WE  ./textures/texture3       
EA ./textures/texture4 

F 220,100,0          
C 225,30,0 

1111
10N1
1101
1111111111111111111