NO ./textures/mine/1.xpm
SO ./textures/mine/2.xpm
WE ./textures/mine/3.xpm
EA ./textures/mine/4.xpm
F 255,255,255
C 0,0,0

       1111111
    1111000001111
   110000000000011
   100111000111001   
   1001 10001 1001   
  11001110W01110011   
  10000000000000001
  10111111111111101
  101           101
  10111  111  11101
  10001110001110001
  10001000100010001
  10100011 11000101
  11 1111   1111 11
