111111111
100111001
1001 1001
100111001
100000N01
111111111