111111111
100101001
110000001
100101001
110000N01
111111111