111111111
100010001
1001 1001
100010001
100000N01
111111111