NO ./textures/mine/1.xpm
SO ./textures/mine/2.xpm
WE ./textures/mine/3.xpm
EA ./textures/mine/4.xpm

F 255,255,255
C 0,0,0

11111111111111111111
10010000000000000001
10010000000000000001
1001110000000000N001
10000000000000110001
10000000000000010001
11111111111111111111
