11111111111
10000000001     
10000000001       
11111110001
    11100011111
    10000001001         
    10100100101
    10010000001
    11111110001        
        11100011111
        10000001001
        1011001 101
        101 1001001
        10010000001       
        11111111111

         111111111
        10000001001
        1011001 101          
        101 1001001
        10010000001
         111111111            


